10 20 12 8 6
0 0 0 0 0 0 0 0 0 0 0 0 0 0 0 0 0 0 0 0 
0 0 0 0 0 3 3 3 3 0 0 0 0 0 0 0 0 0 0 0 
0 0 0 0 7 4 4 4 4 3 3 0 0 0 0 0 0 0 0 0 
0 0 0 0 0 0 2 2 4 4 4 3 0 0 0 0 0 3 0 0 
0 0 0 3 0 0 2 2 2 2 4 3 0 0 3 0 0 0 0 0 
0 0 0 0 0 3 2 2 2 2 4 3 0 0 0 0 0 0 0 0 
0 0 0 0 3 0 6 6 5 4 4 3 0 0 0 0 0 3 0 0 
0 0 0 3 0 3 3 6 6 3 3 0 0 0 0 0 0 0 0 0 
0 0 0 0 0 0 0 3 3 0 0 0 0 3 0 0 0 0 0 0 
0 0 0 0 0 0 0 0 0 0 0 0 0 0 0 0 0 0 0 0 
