10 20 19
1 1 1 1 1 1 1 1 1 1 1 1 1 1 1 1 1 1 1 1
1 0 0 0 0 0 0 0 0 0 3 0 0 0 0 0 3 0 0 1
1 2 4 4 4 3 0 0 0 0 0 0 0 0 0 0 0 0 0 1
1 0 0 4 4 0 0 3 0 0 0 0 3 0 0 0 0 0 0 1
1 0 3 4 4 0 0 0 0 0 0 0 0 0 0 0 3 0 0 1
1 0 0 0 4 0 3 0 0 0 0 0 0 0 0 0 0 0 0 1
1 0 0 4 4 4 4 0 0 3 0 0 0 0 3 0 0 0 0 1
1 0 3 4 3 4 4 4 2 0 0 0 0 0 0 0 0 3 0 1
1 0 0 4 4 4 0 0 0 0 0 3 0 0 0 0 0 0 0 1
1 1 1 1 1 1 1 1 1 1 1 1 1 1 1 1 1 1 1 1