10 20 16 5 6
3 3 3 3 3 3 3 3 3 3 3 3 3 3 3 3 3 3 3 3
3 0 0 0 0 3 3 3 3 0 0 0 0 0 0 0 0 0 0 3
3 0 0 0 7 4 4 4 4 3 3 0 0 0 0 0 0 0 0 3
3 0 0 0 0 0 2 2 4 4 4 3 0 0 0 0 0 3 0 3
3 0 0 3 0 0 2 2 2 2 4 3 0 0 3 0 0 0 0 3
3 0 0 0 0 3 2 2 2 2 4 3 0 0 0 0 0 0 0 3
3 0 0 0 3 0 4 4 4 4 4 3 0 0 0 0 0 3 0 3
3 0 0 3 0 3 3 4 4 3 3 0 0 0 0 0 0 0 0 3
3 0 0 0 0 0 0 3 3 0 0 0 0 3 0 0 0 0 0 3
3 3 3 3 3 3 3 3 3 3 3 3 3 3 3 3 3 3 3 3