10 20 37 13 4
3 3 3 3 3 3 3 3 3 3 3 3 3 3 3 3 3 3 3 3
3 0 0 0 0 0 0 0 0 0 3 3 3 3 0 0 0 0 0 3
3 0 0 0 0 0 3 3 3 3 4 4 4 4 3 0 0 0 0 3
3 0 0 0 0 3 4 4 4 4 4 4 4 4 3 0 0 0 0 3
3 0 0 0 0 3 4 4 4 4 4 4 4 0 3 0 0 0 0 3
3 0 0 0 0 3 4 4 4 4 4 4 4 3 0 0 0 0 0 3
3 0 0 0 0 3 4 4 4 7 4 4 4 4 3 0 0 0 0 3
3 0 0 0 0 0 3 3 3 3 4 4 4 4 3 0 0 0 0 3
3 0 0 0 0 0 0 0 0 0 3 3 3 3 0 0 0 0 0 3
3 3 3 3 3 3 3 3 3 3 3 3 3 3 3 3 3 3 3 3
