10 20 41 10 1
0 0 0 0 0 0 0 3 3 3 3 0 0 3 0 0 0 0 0 0
0 0 3 0 0 0 3 4 4 4 0 3 0 0 0 0 2 3 0 0
0 0 0 0 0 0 3 4 4 4 3 3 3 3 0 0 2 2 0 0
0 3 0 0 0 3 4 4 4 4 4 4 4 4 3 0 2 2 0 3
0 0 0 3 0 3 4 4 4 4 4 3 4 4 3 0 2 0 0 0
0 0 2 2 0 0 3 3 4 4 4 4 4 4 3 0 0 0 0 0
0 2 2 2 0 0 0 3 4 4 4 4 4 4 3 0 3 0 0 0
0 2 2 2 2 0 3 4 4 4 4 3 3 3 0 0 0 0 3 0
0 0 2 2 0 0 3 4 4 4 4 3 0 0 0 0 0 0 0 0
3 0 0 0 0 0 0 3 3 3 7 0 0 0 0 3 0 0 0 0