10 20 22 6 6
0 0 0 0 0 0 0 0 0 0 0 0 0 0 0 0 0 0 0 0
0 0 0 0 0 3 3 0 3 3 0 0 0 0 0 0 0 0 0 0
0 0 0 0 3 4 4 3 4 4 3 0 3 0 0 0 0 3 0 0
0 0 3 0 3 4 4 4 4 4 3 0 0 0 0 0 0 0 0 0
0 0 0 0 3 4 4 3 4 4 3 0 0 0 0 0 3 0 0 0
0 0 0 0 0 3 4 3 4 4 4 3 0 3 0 0 0 0 0 0
0 0 2 0 0 0 0 3 4 7 4 3 0 0 0 0 0 0 0 0
0 0 2 2 2 0 0 3 4 4 4 3 0 0 2 2 2 2 0 0
0 0 2 2 2 0 0 0 3 3 3 0 0 0 0 2 2 2 0 0
0 0 0 0 0 0 0 0 0 0 0 0 0 0 0 0 0 0 0 0