10 20 22 11 4
0 0 0 0 0 0 0 0 0 0 0 0 0 0 0 0 0 0 0 0 
0 0 0 0 0 0 0 0 0 0 3 3 3 3 0 0 0 0 0 0 
0 0 0 0 0 0 3 3 3 3 4 4 6 6 3 0 0 0 0 0 
0 0 0 0 0 3 4 4 4 4 4 4 6 6 3 0 0 0 0 0 
0 0 0 0 0 3 4 4 4 4 4 5 6 0 3 0 0 0 0 0 
0 0 0 0 0 3 4 4 4 4 4 6 6 3 0 0 0 0 0 0 
0 0 0 0 0 3 4 4 4 7 6 6 6 6 3 0 0 0 0 0 
0 0 0 0 0 0 3 3 3 3 6 6 6 6 3 0 0 0 0 0 
0 0 0 0 0 0 0 0 0 0 3 3 3 3 0 0 0 0 0 0 
0 0 0 0 0 0 0 0 0 0 0 0 0 0 0 0 0 0 0 0 
